11,11,11,11,11,11,11,11,11,11,11,11,11,11,11,11,11,11,11,11
11,20,14,14,14,14,14,14,14,19,11,11,11,23,14,14,14,14,19,11
11,15,00,02,03,09,05,05,00,16,11,11,23,18,00,00,00,00,16,11
11,15,00,04,25,06,00,00,00,16,11,11,15,00,00,00,00,00,16,11
11,15,00,00,40,36,00,00,00,16,11,23,18,00,00,00,00,00,16,11
11,15,01,25,02,06,00,00,20,22,11,15,00,00,00,00,00,00,16,11
11,15,01,40,05,08,00,00,16,11,23,18,00,00,00,00,00,00,16,11
11,15,00,00,03,00,00,00,16,11,15,00,00,00,00,00,00,00,16,11
11,17,13,13,13,13,13,13,22,11,17,13,13,13,13,13,13,13,18,11
11,11,11,11,11,11,11,11,11,11,11,11,11,11,11,11,11,11,11,11